0  0  0  0  8  5  5  5  5  5  5  5  5  5  5  5  5  9  0  0  0  0

0  0  0  0  4  1  2  1  2  1  2  1  2  1  2  1  2  6  0  0  0  0

0  0  0  0  4  2  1  2  1  2  1  2  1  2  1  2  1  6  0  0  0  0

0  0  0  0  4  1  2  1  2  1  2  1  2  1  2  1  2  6  0  0  0  0

0  0  0  0  4  2  1  2  1  2  1  2  1  2  1  2  1  6  0  0  0  0

0  0  8  5  12 1  2  1  2  1  2  1  2  1  2  1  2  13 5  9  0  0

0  0  4  49 49 2  1  2  1  2  1  2  1  2  1  2  1  50 50 6  0  0

0  0  4  49 49 1  2  1  2  1  2  1  2  1  2  1  2  50 50 6  0  0

0  0  7  3  11 2  1  2  1  2  1  2  1  2  1  2  1  14 3  10 0  0

0  0  0  0  4  1  2  1  2  1  2  1  2  1  2  1  2  6  0  0  0  0

0  0  0  0  4  2  1  2  1  2  1  2  1  2  1  2  1  6  0  0  0  0

0  0  0  0  4  1  2  1  2  1  2  1  2  1  2  1  2  6  0  0  0  0

0  0  0  0  4  2  1  2  1  2  1  2  1  2  1  2  1  6  0  0  0  0

0  0  0  0  7  3  3  3  3  3  3  3  3  3  3  3  3  10 0  0  0  0

