0  0  0  0  0  0  0  0  8  5  9  8  5  9  0  0  0  0  0  0  0  0

0  0  0  0  0  0  0  8  12 1  13 12 2  13 9  0  0  0  0  0  0  0

0  0  0  0  0  0  8  12 1  2  1  2  1  2  13 9  0  0  0  0  0  0

0  0  0  0  0  0  4  1  2  47 2  1  47 1  50 6  0  0  0  0  0  0

0  0  0  0  0  0  7  11 1  2  1  2  1  2  14 10 0  0  0  0  0  0

0  0  0  0  0  0  8  12 2  1  2  1  2  1  13 9  0  0  0  0  0  0

0  0  0  0  0  0  4  2  1  47 1  2  47 2  1  6  0  0  0  0  0  0

0  0  0  0  0  0  7  11 2  1  2  1  2  1  14 10 0  0  0  0  0  0

0  0  0  0  0  0  8  12 1  2  1  2  1  2  13 9  0  0  0  0  0  0

0  0  0  0  0  0  4  49 2  47 2  1  47 1  2  6  0  0  0  0  0  0

0  0  0  0  0  0  7  11 1  2  1  2  1  2  14 10 0  0  0  0  0  0

0  0  0  0  0  0  0  7  11 1  14 11 2  14 10 0  0  0  0  0  0  0

0  0  0  0  0  0  0  0  7  3  10 7  3  10 0  0  0  0  0  0  0  0

0  0  0  0  0  0  0  0  0  0  0  0  0  0  0  0  0  0  0  0  0  0
